mini game
An Interactive Fiction by kgoodrowe20
Release 1 / Serial number 190220 / Inform 7 build 6M62 (I6/v6.33 lib 6/12N) SD

Ancient Hall
A hallway with walls of stone, decorated with relics and carvings. 

You can see a wooden door to the east.

>e
(first opening the wooden door)

First Chamber
A stone room with a slate pillar in the northwest corner of the room.

The door is at least a couple hundred years old, you can tell because of the lines in the wood.

You can also see Pillar here.

>s
Fourth Chamber

* * *

mini game
An Interactive Fiction by kgoodrowe20
Release 1 / Serial number 190220 / Inform 7 build 6M62 (I6/v6.33 lib 6/12N) SD

Ancient Hall
A hallway with walls of stone, decorated with relics and carvings. 

You can see a wooden door to the east.

>inspect
You must supply a noun.

>inspect relics
I only understood you as far as wanting to inspect.

>x relic
You can't see any such thing.

>x relics
Various clay pots and urns are scattered against the edge of the hallway. Perhaps searching them might yield something of value.

>inspect relics.
I only understood you as far as wanting to inspect.

>inspect walls
I only understood you as far as wanting to inspect.

* * *

mini game
An Interactive Fiction by kgoodrowe20
Release 1 / Serial number 190220 / Inform 7 build 6M62 (I6/v6.33 lib 6/12N) SD

Ancient Hall
A hallway with walls of stone, decorated with relics and carvings. 

You can see a wooden door to the east.

>inspect walls
Strange carvings depicting monsters and warriors cover the surface of the old stone.

* * *

mini game
An Interactive Fiction by kgoodrowe20
Release 1 / Serial number 190220 / Inform 7 build 6M62 (I6/v6.33 lib 6/12N) SD

Ancient Hall
A hallway with walls of stone, decorated with relics and carvings. 

You can see a wooden door to the east.

>ne
You can't go that way.

>open door
You open wooden door.

>ne
You can't go that way.

* * *

>sw
You can't go that way.

>go through door
You can't go that way.

>go through wooden door
You can't go that way.

* * *

>open door
You open wooden door.

>nw
You can't go that way.

>go through door
You can't go that way.

* * *

>ne
You can't go that way.

>sw
Ancient Hall
A hallway with walls of stone, decorated with relics and carvings.

There is a door to the northeast.

* * *

mini game
An Interactive Fiction by kgoodrowe20
Release 1 / Serial number 190220 / Inform 7 build 6M62 (I6/v6.33 lib 6/12N) SD

Ancient Hall
A hallway with walls of stone, decorated with relics and carvings. 

You can see a wooden door to the east.

>nw
You can't go that way.

* * *

mini game
An Interactive Fiction by kgoodrowe20
Release 1 / Serial number 190220 / Inform 7 build 6M62 (I6/v6.33 lib 6/12N) SD

Ancient Hall
A hallway with walls of stone, decorated with relics and carvings. 

You can see a wooden door to the east.

>open door
You open the wooden door.

* * *

>w
You can't go that way.

>e
You can't go that way.

>n
You can't go that way.

* * *

>ne
You can't go that way.

>go through door
You can't go that way.

>open door
That's already open.

>go through door
You can't go that way.

* * *

>use door
That's not a verb I recognise.

>go through door
First Chamber
You can see a wooden door here.

>close door
You close the wooden door.

* * *

mini game
An Interactive Fiction by kgoodrowe20
Release 1 / Serial number 190220 / Inform 7 build 6M62 (I6/v6.33 lib 6/12N) SD

Ancient Hall
A hallway with walls of stone, decorated with relics and carvings. 

You can see a wooden door to the east.

>s
Third Chamber

>e
Fourth Chamber

>n
Second Chamber

>w
First Chamber

>e
Second Chamber

>s
Fourth Chamber

* * *

mini game
An Interactive Fiction by kgoodrowe20
Release 1 / Serial number 190220 / Inform 7 build 6M62 (I6/v6.33 lib 6/12N) SD

Ancient Hall
A hallway with walls of stone, decorated with relics and carvings. 

You can see a wooden door to the east.

>w
Second Chamber

>s
Fourth Chamber

>s
You can't go that way.

>n
Second Chamber

>e
First Chamber

* * *

mini game
An Interactive Fiction by kgoodrowe20
Release 1 / Serial number 190220 / Inform 7 build 6M62 (I6/v6.33 lib 6/12N) SD

Ancient Hall
A hallway with walls of stone, decorated with relics and carvings. 

You can see a wooden door to the east.

>x walls
Strange carvings depicting monsters and warriors cover the surface of the old stone.