dungeon
An Interactive Fiction by kgoodrowe20
Release 1 / Serial number 190228 / Inform 7 build 6M62 (I6/v6.33 lib 6/12N) SD

Ancient Hall
A hallway with walls of stone, decorated with relics and carvings. The only visible passageway is the wooden door to the east.

>e
(first opening the wooden door)

First Chamber
A stone room with a stone pillar in the center of the room.

 

The wall shivers and shakes as the carvings move away to reveal a secret chamber.

>e
Second Chamber
A marble room with two marble pillars in opposite corners of the room.

>s
Fourth Chamber
A ceramic room with four ceramic pyramids.

>w
Third Chamber
A granite room, with two granite spheres in the room. There appears to be a pedestal in the center of the room. The pedestal is irregular, and can be described more like a pillar with a rectangular hole cut into it.

* * *

>s
Fourth Chamber
A ceramic room with four ceramic pyramids.

>x pyramids
A ceramic pyramid, Perhaps it could be pushed?

* * *

>e
(first opening the wooden door)

First Chamber
A stone room with a stone pillar in the center of the room.

 

The wall shivers and shakes as the carvings move away to reveal a secret chamber.

>s
Third Chamber
A granite room, with two granite spheres in the room. There appears to be a pedestal in the center of the room. The pedestal is irregular, and can be described more like a pillar with a rectangular hole cut into it.

>e
Fourth Chamber
A ceramic room with four ceramic pyramids.

>w
Third Chamber
A granite room, with two granite spheres in the room. There appears to be a pedestal in the center of the room. The pedestal is irregular, and can be described more like a pillar with a rectangular hole cut into it.

>n
First Chamber
A stone room with a stone pillar in the center of the room.

>w
Ancient Hall
A hallway with walls of stone, decorated with relics and carvings. The only visible passageway is the wooden door to the east.

>e
First Chamber
A stone room with a stone pillar in the center of the room.

>e
Second Chamber
A marble room with two marble pillars in opposite corners of the room.

* * *

>s
Third Chamber
A granite room, with two granite spheres in the room. There appears to be a pedestal in the center of the room. The pedestal is irregular, and can be described more like a pillar with a rectangular hole cut into it.

>x indentation
You can't see any such thing.

>x spheres
A granite sphere. Perhaps it could be rolled?

>roll granite sphere
You can't see any such thing.

* * *

>e
(first opening the wooden door)

First Chamber
A stone room with a stone pillar in the center of the room.

 

The wall shivers and shakes as the carvings move away to reveal a secret chamber.

>w
Ancient Hall
A hallway with walls of stone, decorated with relics and carvings. The only visible passageway is the wooden door to the east.

* * *

>e
First Chamber
A stone room with a stone pillar in the center of the room.

>x pillar
A dark grey pillar made of solid stone. Perhaps it could be pushed?

>e
Second Chamber
A marble room with two marble pillars in opposite corners of the room.

>x pillars
A pillar made of marble. Perhaps it could be pushed?

* * *

>e
(first opening the wooden door)

First Chamber
A stone room with a stone pillar in the center of the room.

 

The wall shivers and shakes as the carvings move away to reveal a secret chamber.

>x pillar
A dark grey pillar made of solid stone. Perhaps it could be pushed?

The wall shivers and shakes as the carvings move away to reveal a secret chamber.

* * *

>e
(first opening the wooden door)

First Chamber
A stone room with a stone pillar in the center of the room.

 

The wall shivers and shakes as the carvings move away to reveal a secret chamber.

>x stone pillar
You can't see any such thing.

* * *

dungeon
An Interactive Fiction by kgoodrowe20
Release 1 / Serial number 190228 / Inform 7 build 6M62 (I6/v6.33 lib 6/12N) SD

Ancient Hall
A hallway with walls of stone, decorated with relics and carvings. The only visible passageway is the wooden door to the east.

>examine relics
Various clay pots and urns are scattered against the edge of the hallway. Between two particularly mishapen pieces of ceramic, you spot a granite monument.

>l
Ancient Hall
A hallway with walls of stone, decorated with relics and carvings. The only visible passageway is the wooden door to the east.

 

You can also see granite monument here.

* * *

dungeon
An Interactive Fiction by kgoodrowe20
Release 1 / Serial number 190228 / Inform 7 build 6M62 (I6/v6.33 lib 6/12N) SD

Ancient Hall
A hallway with walls of stone, decorated with relics and carvings. The only visible passageway is the wooden door to the east.

>inspect
(the wooden door)
You see nothing special about the wooden door.

>inspect relics
Various clay pots and urns are scattered against the edge of the hallway. Between two particularly mishapen pieces of ceramic, you spot a granite monument.

>x relic
Various clay pots and urns are scattered against the edge of the hallway. Between two particularly mishapen pieces of ceramic, you spot a granite monument.

>x relics
Various clay pots and urns are scattered against the edge of the hallway. Between two particularly mishapen pieces of ceramic, you spot a granite monument.

>inspect relics.
Various clay pots and urns are scattered against the edge of the hallway. Between two particularly mishapen pieces of ceramic, you spot a granite monument.

>inspect walls
Strange carvings depicting monsters and warriors cover the surface of the old stone.

* * *

dungeon
An Interactive Fiction by kgoodrowe20
Release 1 / Serial number 190228 / Inform 7 build 6M62 (I6/v6.33 lib 6/12N) SD

Ancient Hall
A hallway with walls of stone, decorated with relics and carvings. The only visible passageway is the wooden door to the east.

>inspect walls
Strange carvings depicting monsters and warriors cover the surface of the old stone.

* * *

dungeon
An Interactive Fiction by kgoodrowe20
Release 1 / Serial number 190228 / Inform 7 build 6M62 (I6/v6.33 lib 6/12N) SD

Ancient Hall
A hallway with walls of stone, decorated with relics and carvings. The only visible passageway is the wooden door to the east.

>l
Ancient Hall
A hallway with walls of stone, decorated with relics and carvings. The only visible passageway is the wooden door to the east.

>x me
You're an adventurer, and you climb into dungeons like these for treasure in order to make a living. You are dressed in jeans and a t-shirt.

You realize that there's a golden beetle on your shirt, and you flick it onto the ground. It scurries away and starts glowing at the center of the ancient hall floor.

>l
Ancient Hall
A hallway with walls of stone, decorated with relics and carvings. The only visible passageway is the wooden door to the east.

 

You can also see golden beetle here.

* * *

dungeon
An Interactive Fiction by kgoodrowe20
Release 1 / Serial number 190228 / Inform 7 build 6M62 (I6/v6.33 lib 6/12N) SD

Ancient Hall
A hallway with walls of stone, decorated with relics and carvings. The only visible passageway is the wooden door to the east.

>ne
You can't go that way.

>open door
You open the wooden door.

>ne
You can't go that way.

>sw
You can't go that way.

>go through door
First Chamber
A stone room with a stone pillar in the center of the room.

>go through wooden door
Ancient Hall
A hallway with walls of stone, decorated with relics and carvings. The only visible passageway is the wooden door to the east.

* * *

>open door
You open the wooden door.

>nw
You can't go that way.

>go through door
First Chamber
A stone room with a stone pillar in the center of the room.

* * *

dungeon
An Interactive Fiction by kgoodrowe20
Release 1 / Serial number 190228 / Inform 7 build 6M62 (I6/v6.33 lib 6/12N) SD

Ancient Hall
A hallway with walls of stone, decorated with relics and carvings. The only visible passageway is the wooden door to the east.

>nw
You can't go that way.

>open door
You open the wooden door.

* * *

>nw
You can't go that way.

>nw
You can't go that way.

* * *

dungeon
An Interactive Fiction by kgoodrowe20
Release 1 / Serial number 190228 / Inform 7 build 6M62 (I6/v6.33 lib 6/12N) SD

Ancient Hall
A hallway with walls of stone, decorated with relics and carvings. The only visible passageway is the wooden door to the east.

>open door
You open the wooden door.

>close door
You close the wooden door.

* * *

>open door
You open the wooden door.

>s
You can't go that way.

>w
You can't go that way.

>e
First Chamber
A stone room with a stone pillar in the center of the room.

>n
You can't go that way.

>nw
You can't go that way.

>ne
You can't go that way.

>go through door
Ancient Hall
A hallway with walls of stone, decorated with relics and carvings. The only visible passageway is the wooden door to the east.

>open door
That's already open.

>go through door
First Chamber
A stone room with a stone pillar in the center of the room.

* * *

>open door
You open the wooden door.

>use door
That's not a verb I recognise.

>go through door
First Chamber
A stone room with a stone pillar in the center of the room.

>close door
You close the wooden door.

* * *

>open door
You open the wooden door.

>w
You can't go that way.

>w
You can't go that way.

* * *

dungeon
An Interactive Fiction by kgoodrowe20
Release 1 / Serial number 190228 / Inform 7 build 6M62 (I6/v6.33 lib 6/12N) SD

Ancient Hall
A hallway with walls of stone, decorated with relics and carvings. The only visible passageway is the wooden door to the east.

>place
That's not a verb I recognise.

>x relics
Various clay pots and urns are scattered against the edge of the hallway. Between two particularly mishapen pieces of ceramic, you spot a granite monument.

>take granite monument
Taken.

>e
(first opening the wooden door)

First Chamber
A stone room with a stone pillar in the center of the room.

>s
Third Chamber
A granite room, with two granite spheres in the room. There appears to be a pedestal in the center of the room. The pedestal is irregular, and can be described more like a pillar with a rectangular hole cut into it.

>place granite monument on pedestal
That's not a verb I recognise.

>place granite monument
That's not a verb I recognise.

* * *

dungeon
An Interactive Fiction by kgoodrowe20
Release 1 / Serial number 190228 / Inform 7 build 6M62 (I6/v6.33 lib 6/12N) SD

Ancient Hall
A hallway with walls of stone, decorated with relics and carvings. The only visible passageway is the wooden door to the east.

>placing
That's not a verb I recognise.

* * *

dungeon
An Interactive Fiction by kgoodrowe20
Release 1 / Serial number 190228 / Inform 7 build 6M62 (I6/v6.33 lib 6/12N) SD

Ancient Hall
A hallway with walls of stone, decorated with relics and carvings. The only visible passageway is the wooden door to the east.

>push
(the wooden door)
It is fixed in place.

>w
You can't go that way.

>e
(first opening the wooden door)

First Chamber
A stone room with a stone pillar in the center of the room.

I beg your pardon?

>push pillar
It is fixed in place.

>w
Ancient Hall
A hallway with walls of stone, decorated with relics and carvings. The only visible passageway is the wooden door to the east.

* * *

dungeon
An Interactive Fiction by kgoodrowe20
Release 1 / Serial number 190228 / Inform 7 build 6M62 (I6/v6.33 lib 6/12N) SD

Ancient Hall
A hallway with walls of stone, decorated with relics and carvings. The only visible passageway is the wooden door to the east.

>s
You can't go that way.

>e
(first opening the wooden door)

First Chamber
A stone room with a stone pillar in the center of the room.

>e
Second Chamber
A marble room with two marble pillars in opposite corners of the room.

* * *

>w
Third Chamber
A granite room, with two granite spheres in the room. There appears to be a pedestal in the center of the room. The pedestal is irregular, and can be described more like a pillar with a rectangular hole cut into it.

>s
You can't go that way.

>d
You can't go that way.

>e
Fourth Chamber
A ceramic room with four ceramic pyramids.

* * *

>e
(first opening the wooden door)

First Chamber
A stone room with a stone pillar in the center of the room.

>n
You can't go that way.

>w
Ancient Hall
A hallway with walls of stone, decorated with relics and carvings. The only visible passageway is the wooden door to the east.

* * *

>e
First Chamber
A stone room with a stone pillar in the center of the room.

>s
Third Chamber
A granite room, with two granite spheres in the room. There appears to be a pedestal in the center of the room. The pedestal is irregular, and can be described more like a pillar with a rectangular hole cut into it.

* * *

dungeon
An Interactive Fiction by kgoodrowe20
Release 1 / Serial number 190228 / Inform 7 build 6M62 (I6/v6.33 lib 6/12N) SD

Ancient Hall
A hallway with walls of stone, decorated with relics and carvings. The only visible passageway is the wooden door to the east.

>take granite monument
You can't see any such thing.

>x relics
Various clay pots and urns are scattered against the edge of the hallway. Between two particularly mishapen pieces of ceramic, you spot a granite monument.

* * *

>s
Third Chamber
A granite room, with two granite spheres in the room. There appears to be a pedestal in the center of the room. The pedestal is irregular, and can be described more like a pillar with a rectangular hole cut into it.

>put granite monument in indentation
You can't see any such thing.

>i
You are carrying:
  granite monument

* * *

dungeon
An Interactive Fiction by kgoodrowe20
Release 1 / Serial number 190228 / Inform 7 build 6M62 (I6/v6.33 lib 6/12N) SD

Ancient Hall
A hallway with walls of stone, decorated with relics and carvings. The only visible passageway is the wooden door to the east.

>w
You can't go that way.

* * *

>e
Second Chamber
A marble room with two marble pillars in opposite corners of the room.

>take granite monument
You can't see any such thing.

>s
Fourth Chamber
A ceramic room with four ceramic pyramids.

* * *

>w
Third Chamber
A granite room, with two granite spheres in the room. There appears to be a pedestal in the center of the room. The pedestal is irregular, and can be described more like a pillar with a rectangular hole cut into it.

>put granite monument in indentation
You can't see any such thing.

* * *

>take granite monument
You can't see any such thing.

>w
First Chamber
A stone room with a stone pillar in the center of the room.

>e
Second Chamber
A marble room with two marble pillars in opposite corners of the room.

* * *

>w
Third Chamber
A granite room, with two granite spheres in the room. There appears to be a pedestal in the center of the room. The pedestal is irregular, and can be described more like a pillar with a rectangular hole cut into it.

>drop granite monument
You can't see any such thing.

>put
What do you want to put on?

* * *

>w
You can't go that way.

>s
You can't go that way.

>s
You can't go that way.

>n
You can't go that way.

>e
(first opening the wooden door)

First Chamber
A stone room with a stone pillar in the center of the room.

* * *

dungeon
An Interactive Fiction by kgoodrowe20
Release 1 / Serial number 190228 / Inform 7 build 6M62 (I6/v6.33 lib 6/12N) SD

Ancient Hall
A hallway with walls of stone, decorated with relics and carvings. The only visible passageway is the wooden door to the east.

>x carving
You can't see any such thing.

* * *

dungeon
An Interactive Fiction by kgoodrowe20
Release 1 / Serial number 190228 / Inform 7 build 6M62 (I6/v6.33 lib 6/12N) SD

Ancient Hall
A hallway with walls of stone, decorated with relics and carvings. The only visible passageway is the wooden door to the east.

>x carvings
Upon closer inspection of the carvings, you can see that one of the warriors" swords is actually a lever in the wall.

>e
(first opening the wooden door)

First Chamber
A stone room with a stone pillar in the center of the room.

 

The wall shivers and shakes as the carvings move away to reveal a secret chamber.

>w
Ancient Hall
A hallway with walls of stone, decorated with relics and carvings. The only visible passageway is the wooden door to the east.

 

You can also see a lever here.

The wall shivers and shakes as the carvings move away to reveal a secret chamber.

* * *

>x carvings
Upon closer inspection of the carvings, you can see that one of the warriors" swords is actually a lever in the wall.

>press shield button
You can't see any such thing.

* * *

>x carvings
Upon closer inspection of the carvings, you can see that one of the warriors" swords is actually a lever in the wall.

>pull lever
Nothing obvious happens.

>pull me
You might not like that.

>pull relics
It is fixed in place.

* * *

>pull lever
Nothing obvious happens.

>turn lever on
You switch the lever on.

>n
Secret Chamber

* * *

>x carvings
Upon closer inspection of the carvings, you can see that one of the warriors" swords is actually a lever in the wall.

>turn on lever
The wall shivers and shakes as the carvings move away to reveal a secret chamber.

>n
Secret Chamber
A room made of carved out stone.

>s
Ancient Hall
A hallway with walls of stone, decorated with relics and carvings. The only visible passageway is the wooden door to the east.

 

You can also see a lever here.

>s
You can't go that way.

>pull lever
Try turning the lever on.

>use lever
That's not a verb I recognise.

* * *

dungeon
An Interactive Fiction by kgoodrowe20
Release 1 / Serial number 190228 / Inform 7 build 6M62 (I6/v6.33 lib 6/12N) SD

Ancient Hall
A hallway with walls of stone, decorated with relics and carvings. The only visible passageway is the wooden door to the east.

>x door
You see nothing special about the wooden door.

* * *

dungeon
An Interactive Fiction by kgoodrowe20
Release 1 / Serial number 190228 / Inform 7 build 6M62 (I6/v6.33 lib 6/12N) SD

Ancient Hall
A hallway with walls of stone, decorated with relics and carvings. The only visible passageway is the wooden door to the east.

>x granite monument
You can't see any such thing.

* * *

dungeon
An Interactive Fiction by kgoodrowe20
Release 1 / Serial number 190228 / Inform 7 build 6M62 (I6/v6.33 lib 6/12N) SD

Ancient Hall
A hallway with walls of stone, decorated with relics and carvings. The only visible passageway is the wooden door to the east.

>x me
You're an adventurer, and you climb into dungeons like these for treasure in order to make a living. You are dressed in jeans and a t-shirt.

You realize that there's a golden beetle on your shirt, and you flick it onto the ground. It scurries away and starts glowing at the center of the ancient hall floor.

>take beetle
Taken.

>x beetle
A small bug that sheens like solid gold.

>x walls
Strange carvings depicting monsters and warriors cover the surface of the old stone.

>x carvings
Upon closer inspection of the carvings, you can see that one of the warriors" swords is actually a lever in the wall.

>use lever
That's not a verb I recognise.

>pull lever
Nothing obvious happens.

>switch lever on
You switch the lever on.

yuh

* * *

>x me
You're an adventurer, and you climb into dungeons like these for treasure in order to make a living. You are dressed in jeans and a t-shirt.

You realize that there's a golden beetle on your shirt, and you flick it onto the ground. It scurries away and starts glowing at the center of the ancient hall floor.

>x beetle
A small bug that sheens like solid gold.

>x golden beetle
A small bug that sheens like solid gold.

* * *

>x me
You're an adventurer, and you climb into dungeons like these for treasure in order to make a living. You are dressed in jeans and a t-shirt.

You realize that there's a golden beetle on your shirt, and you flick it onto the ground. It scurries away and starts glowing at the center of the ancient hall floor.

>x gold beetle
A small bug that sheens like solid gold.

* * *

dungeon
An Interactive Fiction by kgoodrowe20
Release 1 / Serial number 190228 / Inform 7 build 6M62 (I6/v6.33 lib 6/12N) SD

Ancient Hall
A hallway with walls of stone, decorated with relics and carvings. The only visible passageway is the wooden door to the east.

>x relic
Various clay pots and urns are scattered against the edge of the hallway. Between two particularly mishapen pieces of ceramic, you spot a granite monument.

>take granite
Taken.

>e
(first opening the wooden door)

First Chamber
A stone room with a stone pillar in the center of the room.

>s
Third chamber
 A granite room, with two granite spheres in the room. There appears to be a pedestal in the center of the room. The pedestal is irregular, and can be described more like a pillar with a rectangular hole cut into it.

>insert granite into pedestal
The monument begins to vibrate, and the eyes glow. It's mouth opens and reveals a glass orb.

>l
Third chamber
 A granite room, with two granite spheres in the room. There appears to be a pedestal in the center of the room. The pedestal is irregular, and can be described more like a pillar with a rectangular hole cut into it. 

You can see granite monument and orb here.

>take orb
The monument spins inside the pedestal, and the pedestal sinks into the floor.

>l
Third chamber
 A granite room with two granite spheres in the room. That's all it is, now.

>drop orb
Why would you do that?

* * *

>l
Third chamber
 A granite room with two granite spheres in the room. That's all it is, now.

>l
Third chamber
 A granite room with two granite spheres in the room. That's all it is, now.

>drop orb
Dropped.

>l
Third chamber
 A granite room, with two granite spheres in the room. There appears to be a pedestal in the center of the room. The pedestal is irregular, and can be described more like a pillar with a rectangular hole cut into it. 

You can see orb here.

* * *

>x relic
Various clay pots and urns are scattered against the edge of the hallway. Between two particularly mishapen pieces of ceramic, you spot a granite monument.

>take granite monument
Taken.

* * *

>x relic
Various clay pots and urns are scattered against the edge of the hallway. Between two particularly mishapen pieces of ceramic, you spot a granite monument.

>take monument
Taken.

>x carvings
Upon closer inspection of the carvings, you can see that one of the warriors" swords is actually a lever in the wall.

>pull lever
Try turning the lever on.

>turn lever on
The wall shivers and shakes as the carvings move away to reveal a secret chamber to the north.

>e
(first opening the wooden door)

First Chamber
A stone room with a stone pillar in the center of the room.

* * *

>s
Third chamber
 A granite room, with two granite spheres in the room. There appears to be a pedestal in the center of the room. The pedestal is irregular, and can be described more like a pillar with a rectangular hole cut into it.

>insert monument into pedestal
The monument begins to vibrate, and the eyes glow. It's mouth opens and reveals a glass orb.

>take orb
The monument spins inside the pedestal, and the pedestal sinks into the floor.

* * *

>l
Third chamber
 A granite room with two granite spheres in the room. That's all it is, now.

>e
Fourth Chamber
A ceramic room with four ceramic pyramids.

>e
You can't go that way.

>n
Second Chamber
A marble room with two marble pillars in opposite corners of the room.

>w
First Chamber
A stone room with a stone pillar in the center of the room.

>w
Ancient Hall
A hallway with walls of stone, decorated with relics and carvings. The only visible passageway is the wooden door to the east.

 

You can also see a lever here.

>n
Secret Chamber
A room made of carved out stone. You can see a stand here.

>insert orb into stand
The orb begins to glow and spin similarly to how the monument did. The stand opens to reveal the golden treasure.

>take treasure
You take the treasure and leave the dungeon. This is sure to net you many, many bundles of cash.

    *** The End ***

Would you like to RESTART, RESTORE a saved game, QUIT or UNDO the last command?

* * *

dungeon
An Interactive Fiction by kgoodrowe20
Release 1 / Serial number 190228 / Inform 7 build 6M62 (I6/v6.33 lib 6/12N) SD

Ancient Hall
A hallway with walls of stone, decorated with relics and carvings. The only visible passageway is the wooden door to the east.

>x relics
Various clay pots and urns are scattered against the edge of the hallway. Between two particularly mishapen pieces of ceramic, you spot a granite monument.

>t granite
That's not a verb I recognise.

>take granite
Taken.

* * *

>e
(first opening the wooden door)

First Chamber
A stone room with a stone pillar in the center of the room.

>w
Ancient Hall
A hallway with walls of stone, decorated with relics and carvings. The only visible passageway is the wooden door to the east.

* * *

>place granite monument on pedestal
That's not a verb I recognise.

>insert
(granite monument in granite monument)
You can't put something inside itself.

>insert granite monument on pedestal
I didn't understand that sentence.

>insert granite monument into pedestal
The monument begins to vibrate, and the eyes glow. It's mouth opens and reveals a glass orb.

* * *

>take granite monument
Taken.

>x granite monument
A small statuette, likened to a lion.

>w
You can't go that way.

* * *

>s
Third Chamber
A granite room, with two granite spheres in the room. There appears to be a pedestal in the center of the room. The pedestal is irregular, and can be described more like a pillar with a rectangular hole cut into it.

>unlock indentation
You can't see any such thing.

* * *

>x relics
Various clay pots and urns are scattered against the edge of the hallway. Between two particularly mishapen pieces of ceramic, you spot a granite monument.

>take moneument
You can't see any such thing.

>take granite
Taken.

* * *

>s
Third Chamber
A granite room, with two granite spheres in the room. There appears to be a pedestal in the center of the room. The pedestal is irregular, and can be described more like a pillar with a rectangular hole cut into it.

>insert monument into pedestal
The monument begins to vibrate, and the eyes glow. It's mouth opens and reveals a glass orb.

>x orb
A clear glass orb, similar to something that a fortune teller might use, but smaller.

>l
Third Chamber
A granite room, with two granite spheres in the room. There appears to be a pedestal in the center of the room. The pedestal is irregular, and can be described more like a pillar with a rectangular hole cut into it. 

You can see granite monument and orb here.

>take orb
Taken.

>i
You are carrying:
  orb

>x granite monument
A small statuette, likened to a lion.

* * *

>x relics
Various clay pots and urns are scattered against the edge of the hallway. Between two particularly mishapen pieces of ceramic, you spot a granite monument.

>take monument
Taken.

>e
(first opening the wooden door)

First Chamber
A stone room with a stone pillar in the center of the room.

* * *

>s
Third Chamber
A granite room, with two granite spheres in the room. There appears to be a pedestal in the center of the room. The pedestal is irregular, and can be described more like a pillar with a rectangular hole cut into it.

>inser monument
That's not a verb I recognise.

>insert
(granite monument in granite monument)
You can't put something inside itself.

>insert monument into pedestal
The monument begins to vibrate, and the eyes glow. It's mouth opens and reveals a glass orb.

* * *

>take orb
The monument spins inside the pedestal, and the pedestal sinks into the floor.

>l
Third Chamber
A granite room, with two granite spheres in the room. There appears to be a pedestal in the center of the room. The pedestal is irregular, and can be described more like a pillar with a rectangular hole cut into it.

* * *

>insert monument into pedestal
The monument begins to vibrate, and the eyes glow. It's mouth opens and reveals a glass orb.

>i
You are carrying nothing.

>take orb
Taken.

>l
Third Chamber
A granite room, with two granite spheres in the room. There appears to be a pedestal in the center of the room. The pedestal is irregular, and can be described more like a pillar with a rectangular hole cut into it. 

You can see granite monument here.

* * *

>take monument
Taken.

>w
You can't go that way.

* * *

>insert monument into pedestal
The monument begins to vibrate, and the eyes glow. It's mouth opens and reveals a glass orb.

>l
Third Chamber
A granite room, with two granite spheres in the room. There appears to be a pedestal in the center of the room. The pedestal is irregular, and can be described more like a pillar with a rectangular hole cut into it. 

You can see granite monument and orb here.

* * *

>take orb
Taken.

>x orb
A clear glass orb, similar to something that a fortune teller might use, but smaller.

* * *

dungeon
An Interactive Fiction by kgoodrowe20
Release 1 / Serial number 190228 / Inform 7 build 6M62 (I6/v6.33 lib 6/12N) SD

Ancient Hall
A hallway with walls of stone, decorated with relics and carvings. The only visible passageway is the wooden door to the east.

>x time
You can't see any such thing.

* * *

dungeon
An Interactive Fiction by kgoodrowe20
Release 1 / Serial number 190228 / Inform 7 build 6M62 (I6/v6.33 lib 6/12N) SD

Ancient Hall
A hallway with walls of stone, decorated with relics and carvings. The only visible passageway is the wooden door to the east.

>x walls
Strange carvings depicting monsters and warriors cover the surface of the old stone.

>x relic
Various clay pots and urns are scattered against the edge of the hallway. Between two particularly mishapen pieces of ceramic, you spot a granite monument.

* * *

>take orb
The monument spins inside the pedestal, and the pedestal sinks into the floor.

>n
First Chamber
A stone room with a stone pillar in the center of the room.

>e
Second Chamber
A marble room with two marble pillars in opposite corners of the room.

>w
First Chamber
A stone room with a stone pillar in the center of the room.

>w
Ancient Hall
A hallway with walls of stone, decorated with relics and carvings. The only visible passageway is the wooden door to the east.

>x carvings
Upon closer inspection of the carvings, you can see that one of the warriors" swords is actually a lever in the wall.

>turn on lever
The wall shivers and shakes as the carvings move away to reveal a secret chamber to the north.

>n
Secret Chamber
A room made of carved out stone. You can see a stand here.

>put orb on stand
The orb begins to glow and spin similarly to how the monument did. The stand opens to reveal the golden treasure.

>i
You are carrying nothing.

>restart
Are you sure you want to restart?

>yes
mini game
An Interactive Fiction by kgoodrowe20
Release 1 / Serial number 190228 / Inform 7 build 6M62 (I6/v6.33 lib 6/12N) SD

Ancient Hall
A hallway with walls of stone, decorated with relics and carvings. The only visible passageway is the wooden door to the east.

>x relic
Various clay pots and urns are scattered against the edge of the hallway. Between two particularly mishapen pieces of ceramic, you spot a granite monument.

* * *

>s
Third chamber
 A granite room, with two granite spheres in the room. There appears to be a pedestal in the center of the room. The pedestal is irregular, and can be described more like a pillar with a rectangular hole cut into it.

>put monument on pedestal
The monument begins to vibrate, and the eyes glow. It's mouth opens and reveals a glass orb.

* * *

dungeon
An Interactive Fiction by kgoodrowe20
Release 1 / Serial number 190228 / Inform 7 build 6M62 (I6/v6.33 lib 6/12N) SD

Ancient Hall
A hallway with walls of stone, decorated with relics and carvings. The only visible passageway is the wooden door to the east.

>x wooden door
You see nothing special about the wooden door.